@ @ @ * @ @ @ @ @ @ # @ @ @ @
@       @       @ @   @ @   @
@   @   @   @   @           @
@ @ @           @   @   @   @
@       @ @ @ @ @   @ @ @ @ @
@ @ @   @   @   @           @
@   @   @   @   @   @ @ @   @
@   @   @       @       @   @
@   @   @   @   @   @ @ @   @
@       @   @   @   @   @   @
@ @ @   @       @   @   @   @
@       @   @   @   @       @
@   @ @ @   @   @ @ @ @ @   @
@                           @
@ @ @ @ @ @ @ @ @ @ @ @ @ @ @