@ @ @ @ @ @ @ @ @
@               @
@   @ @ @ @ @   @
@   @       @   @
@   @   @   @   @
@   @   @ # @   @
@   @   @ @ @   @
@   @           @
@ * @ @ @ @ @ @ @