@ @ @ @ @ @ @ @ @
@       @       @
@   @   @   @   @
@   @   @   @   @
@   @   @   @   @
@   @   @   @   @
@   @ @ @   @ @ @
#               *
@ @ @ @ @ @ @ @ @