@ @ @ @ @ @ @ 
@   @       @
@   @ # @   @
@   @ @ @   @
@           @
@   @   @   @
@ * @ @ @ @ @