@ @ @ @ @ @ @ @ @ @ @
@                   @
@   @ @ @   @   @   @
@       @   @   @   @
@   @   @   @   @   @
@   @ @ @   @   @   @
@       @   @   @   @
@ @ @ @ @ * @   @   @
@   @ @ @ @ @   @   @
@               @ # @
@ @ @ @ @ @ @ @ @ @ @